XXXXXXXXXXX00000000
XXXXXXXXXXX00000000
XXXXXXXXXXX00000000
XXXXXXXXX0000000000
XXXXXX0000000000000
XXXXX00000000000000
XXXXX00000000000000
XXXXX00000000000000
XXX0000000000000000
XXX000000000000000X
XXX0000000000000XXX
X000000000000000XXX
00000000000000XXXXX
0000000000000XXXXXX
0000000000XXXXXXXXX
0000000000XXXXXXXXX
0000000000XXXXXXXXX
000000000XXXXXXXXXX
000000000XXXXXXXXXX
